model,nodes,edges,elements,polygons,bonds,rigids,time
a.s00000021__s00000698.tpn_0.json,60,66,126,15,0,1,30194625
a.s00000023__s00000777.tpn_0.json,70,78,148,18,0,1,22722449
a.s00000023__s00000863.tpn_0.json,26,28,54,6,0,1,7281118
a.s00000023__s00000863.tpn_1.json,38,43,81,9,0,1,7117401
a.s00000025__s00001059.tpn_0.json,99,117,216,26,0,1,21692857
a.s00000025__s00001098.tpn_0.json,58,70,128,15,0,1,9414442
a.s00000029__s00001009.tpn_0.json,66,77,143,17,0,1,12200744
a.s00000029__s00001081.tpn_0.json,72,82,154,19,0,1,12637294
a.s00000029__s00001116.tpn_0.json,82,93,175,21,0,1,12111168
a.s00000029__s00001135.tpn_0.json,39,43,82,10,0,1,7193266
a.s00000029__s00001148.tpn_0.json,83,98,181,22,0,1,39593959
a.s00000029__s00001158.tpn_0.json,81,96,177,21,0,1,10188442
a.s00000029__s00001170.tpn_0.json,42,48,90,10,0,1,5727288
a.s00000031__s00001218.tpn_0.json,41,46,87,10,0,1,5052717
a.s00000031__s00001361.tpn_0.json,129,163,292,34,0,1,16886700
a.s00000033__s00001232.tpn_0.json,119,174,293,31,0,1,17945439
a.s00000035__s00001370.tpn_0.json,26,28,54,6,0,1,1979213
a.s00000035__s00001374.tpn_0.json,105,123,228,29,0,1,8858265
a.s00000035__s00001397.tpn_0.json,57,62,119,14,0,1,6611965
a.s00000035__s00001411.tpn_0.json,42,47,89,10,0,1,3428359
a.s00000035__s00001416.tpn_0.json,80,97,177,21,0,1,8036152
a.s00000035__s00001435.tpn_0.json,40,44,84,10,0,1,2369703
a.s00000041__s00001526.tpn_0.json,26,28,54,6,0,1,2270520
a.s00000043__s00000846.tpn_0.json,71,87,158,20,0,1,6395127
a.s00000043__s00001444.tpn_0.json,73,90,163,21,0,1,4125427
a.s00000043__s00001452.tpn_0.json,100,120,220,26,0,1,6944243
a.s00000043__s00001472.tpn_0.json,73,90,163,21,0,1,6276240
a.s00000045__s00001491.tpn_0.json,59,65,124,15,0,1,3351181
a.s00000045__s00001601.tpn_0.json,49,56,105,12,0,1,2489658
a.s00000045__s00001610.tpn_0.json,49,59,108,12,0,1,3145099
a.s00000045__s00001845.tpn_0.json,49,56,105,12,0,1,4113276
a.s00000045__s00001909.tpn_0.json,26,28,54,6,0,1,1634128
a.s00000045__s00001920.tpn_0.json,86,149,235,24,0,1,5527035
a.s00000045__s00001942.tpn_0.json,86,107,193,22,0,1,4524538
a.s00000045__s00001958.tpn_0.json,72,80,152,19,0,1,4605329
a.s00000045__s00001978.tpn_0.json,56,80,136,15,0,1,3769011
a.s00000049__s00000898.tpn_0.json,41,52,93,11,0,1,1756463
a.s00000049__s00000915.tpn_0.json,31,36,67,8,0,1,1784051
a.s00000049__s00000950.tpn_0.json,61,76,137,16,0,1,3790605
a.s00000049__s00000959.tpn_0.json,40,47,87,11,0,1,1788895
a.s00000049__s00001005.tpn_0.json,58,66,124,15,0,1,2958475
a.s00000049__s00001827.tpn_0.json,117,188,305,31,0,1,8383290
a.s00000055__s00001665.tpn_0.json,61,76,137,16,0,1,2555505
a.s00000059__s00001992.tpn_0.json,26,28,54,6,0,1,947569
a.s00000059__s00002007.tpn_0.json,33,38,71,8,0,1,1303246
a.s00000063__s00001849.tpn_0.json,135,224,359,36,0,1,10300597
a.s00000063__s00002019.tpn_0.json,61,76,137,16,0,1,3452580
a.s00000063__s00002333.tpn_0.json,42,48,90,10,0,1,2170271
a.s00000067__s00001795.tpn_0.json,94,112,206,25,0,1,7373978
a.s00000067__s00002352.tpn_0.json,26,28,54,6,0,1,1408340
a.s00000067__s00002370.tpn_0.json,33,36,69,8,0,1,2060579
a.s00000069__s00002359.tpn_0.json,55,65,120,14,0,1,3073093
a.s00000069__s00002375.tpn_0.json,73,82,155,19,0,1,3215216
a.s00000069__s00002383.tpn_0.json,59,69,128,15,0,1,3814415
a.s00000071__s00002391.tpn_0.json,37,42,79,9,0,1,1419670
a.s00000073__s00002401.tpn_0.json,70,78,148,18,0,1,3237384
a.s00000073__s00002418.tpn_0.json,37,42,79,9,0,1,2119776
a.s00000083__s00002427.tpn_0.json,38,43,81,9,0,1,2637364
a.s00000083__s00002433.tpn_0.json,56,67,123,14,0,1,3229913
a.s00000090__s00001030.tpn_0.json,82,95,177,21,0,1,5374813
a.s00000090__s00002274.tpn_0.json,76,96,172,20,0,1,5031944
a.s00000090__s00002444.tpn_0.json,107,127,234,29,0,1,5568252
a.s00000090__s00002474.tpn_0.json,42,48,90,10,0,1,1500543
a.s00000092__s00002041.tpn_0.json,88,100,188,23,0,1,4657219
a.s00000092__s00002055.tpn_0.json,41,46,87,10,0,1,1970839
a.s00000092__s00002621.tpn_0.json,168,219,387,46,0,1,15452661
a.s00000092__s00002644.tpn_0.json,69,81,150,18,0,1,4820443
a.s00000094__s00002029.tpn_0.json,86,106,192,22,0,1,4877095
a.s00000098__s00001515.tpn_0.json,41,46,87,10,0,1,1428127
a.s00000098__s00002282.tpn_0.json,59,71,130,15,0,1,2551564
a.s00000098__s00002661.tpn_0.json,35,40,75,9,0,1,1322048
a.s00000098__s00002668.tpn_0.json,35,40,75,9,0,1,1186575
a.s00000098__s00002672.tpn_0.json,42,48,90,10,0,1,2014354
a.s00000098__s00002679.tpn_0.json,42,48,90,10,0,1,2006226
a.s00000098__s00002696.tpn_0.json,35,40,75,9,0,1,1199219
a.s00000100__s00003060.tpn_0.json,82,99,181,21,0,1,3628038
a.s00000102__s00002058.tpn_0.json,101,122,223,28,0,1,5146891
a.s00000102__s00002085.tpn_0.json,54,64,118,13,0,1,2351229
a.s00000102__s00002437.tpn_0.json,58,69,127,14,0,1,2475618
a.s00000102__s00002464.tpn_0.json,28,30,58,6,0,1,945763
a.s00000102__s00002464.tpn_1.json,60,70,130,15,0,1,2673325
a.s00000102__s00002699.tpn_0.json,54,64,118,13,0,1,3301179
a.s00000102__s00002740.tpn_0.json,55,66,121,14,0,1,2484731
a.s00000104__s00002287.tpn_0.json,48,55,103,12,0,1,2318141
a.s00000104__s00002568.tpn_0.json,37,40,77,9,0,1,1324757
a.s00000104__s00002568.tpn_1.json,71,83,154,18,0,1,3867537
a.s00000104__s00002591.tpn_0.json,42,48,90,10,0,1,1692504
a.s00000104__s00002765.tpn_0.json,26,28,54,6,0,1,1605884
a.s00000104__s00002780.tpn_0.json,85,103,188,22,0,1,4165002
a.s00000104__s00002789.tpn_0.json,26,28,54,6,0,1,1648250
a.s00000104__s00002789.tpn_1.json,108,127,235,28,0,1,5380561
a.s00000104__s00002804.tpn_0.json,37,42,79,9,0,1,1392904
a.s00000104__s00002804.tpn_1.json,30,32,62,6,0,1,1109479
a.s00000104__s00002816.tpn_0.json,48,55,103,12,0,1,1930443
a.s00000104__s00002819.tpn_0.json,37,42,79,9,0,1,1400376
a.s00000104__s00002824.tpn_0.json,26,28,54,6,0,1,3365303
a.s00000104__s00002829.tpn_0.json,37,42,79,9,0,1,3241325
a.s00000104__s00002851.tpn_0.json,48,55,103,12,0,1,3323266
a.s00000104__s00002858.tpn_0.json,37,42,79,9,0,1,2297204
a.s00000104__s00002860.tpn_0.json,26,28,54,6,0,1,1181567
a.s00000104__s00002863.tpn_0.json,37,42,79,9,0,1,1914515
a.s00000104__s00002865.tpn_0.json,48,55,103,12,0,1,1831835
a.s00000104__s00002872.tpn_0.json,95,112,207,25,0,1,5507166
a.s00000104__s00002891.tpn_0.json,37,42,79,9,0,1,2081680
a.s00000104__s00002892.tpn_0.json,37,42,79,9,0,1,1466798
a.s00000104__s00002895.tpn_0.json,37,42,79,9,0,1,2481529
a.s00000104__s00002898.tpn_0.json,33,38,71,8,0,1,1965255
a.s00000104__s00002900.tpn_0.json,37,42,79,9,0,1,3292723
a.s00000104__s00002905.tpn_0.json,118,143,261,30,0,1,9018123
a.s00000106__s00002022.tpn_0.json,69,86,155,18,0,1,6562785
a.s00000106__s00002479.tpn_0.json,72,86,158,19,0,1,9294816
a.s00000106__s00002557.tpn_0.json,76,90,166,20,0,1,3143703
a.s00000106__s00002598.tpn_0.json,143,175,318,38,0,1,10939699
a.s00000106__s00002617.tpn_0.json,42,47,89,10,0,1,7199999
a.s00000106__s00002866.tpn_0.json,48,54,102,12,0,1,4956983
a.s00000106__s00002916.tpn_0.json,48,54,102,12,0,1,6310970
a.s00000106__s00002922.tpn_0.json,48,54,102,12,0,1,2138004
a.s00000106__s00002929.tpn_0.json,53,60,113,13,0,1,1991118
a.s00000106__s00002939.tpn_0.json,26,28,54,6,0,1,3584604
a.s00000106__s00002944.tpn_0.json,113,136,249,30,0,1,7693940
a.s00000108__s00002507.tpn_0.json,71,84,155,18,0,1,6249063
a.s00000108__s00002965.tpn_0.json,109,134,243,28,0,1,8807607
a.s00000108__s00002983.tpn_0.json,90,106,196,23,0,1,7595332
a.s00000108__s00002990.tpn_0.json,49,55,104,12,0,1,3893071
a.s00000108__s00003001.tpn_0.json,163,222,385,43,0,1,11153089
a.s00000108__s00003025.tpn_0.json,40,44,84,10,0,1,4986376
a.s00000108__s00003032.tpn_0.json,142,170,312,37,0,1,12629494
a.s00000110__s00002684.tpn_0.json,66,75,141,17,0,1,2741226
a.s00000112__s00001261.tpn_0.json,57,68,125,14,0,1,2638595
a.s00000112__s00001319.tpn_0.json,99,114,213,26,0,1,6588812
a.s00000112__s00001319.tpn_1.json,30,32,62,6,0,1,1045027
a.s00000112__s00003098.tpn_0.json,42,47,89,10,0,1,5702739
a.s00000112__s00003151.tpn_0.json,63,74,137,16,0,1,5730901
a.s00000112__s00003164.tpn_0.json,37,42,79,9,0,1,1933399
a.s00000112__s00003218.tpn_0.json,48,55,103,12,0,1,3934863
a.s00000112__s00003242.tpn_0.json,66,79,145,17,0,1,7749935
a.s00000112__s00003250.tpn_0.json,74,91,165,19,0,1,6272791
a.s00000112__s00003260.tpn_0.json,100,145,245,27,0,1,7187683
a.s00000112__s00003267.tpn_0.json,87,118,205,23,0,1,8219656
a.s00000113__s00001194.tpn_0.json,83,108,191,22,0,1,8123101
a.s00000115__s00003080.tpn_0.json,76,96,172,20,0,1,3626560
a.s00000115__s00003088.tpn_0.json,80,90,170,21,0,1,3232047
a.s00000117__s00003105.tpn_0.json,98,117,215,26,0,1,4325352
a.s00000117__s00003115.tpn_0.json,163,204,367,43,0,1,10079735
a.s00000119__s00003356.tpn_0.json,44,50,94,11,0,1,2484403
a.s00000121__s00003273.tpn_0.json,59,69,128,15,0,1,2591960
a.s00000121__s00003283.tpn_0.json,94,124,218,24,0,1,7378166
a.s00000121__s00003378.tpn_0.json,134,193,327,35,0,1,10699461
a.s00000123__s00003318.tpn_0.json,94,106,200,24,0,1,9319939
a.s00000123__s00003330.tpn_0.json,86,96,182,22,0,1,7689342
a.s00000125__s00001640.tpn_0.json,72,91,163,18,0,1,6136169
a.s00000125__s00003341.tpn_0.json,44,50,94,11,0,1,5397228
a.s00000127__s00003299.tpn_0.json,83,93,176,22,0,1,7344667
a.s00000131__s00002501.tpn_0.json,55,62,117,14,0,1,4444322
a.s00000131__s00003596.tpn_0.json,106,119,225,28,0,1,4892859
a.s00000131__s00003626.tpn_0.json,104,118,222,27,0,1,8005445
a.s00000131__s00003630.tpn_0.json,97,110,207,25,0,1,8210624
a.s00000131__s00003631.tpn_0.json,69,79,148,17,0,1,3354301
a.s00000131__s00003633.tpn_0.json,104,118,222,27,0,1,5490909
a.s00000131__s00003635.tpn_0.json,80,90,170,20,0,1,3341739
a.s00000131__s00003638.tpn_0.json,76,87,163,19,0,1,4974635
a.s00000131__s00003639.tpn_0.json,76,85,161,19,0,1,3981662
a.s00000135__s00001932.tpn_0.json,57,68,125,14,0,1,2450412
a.s00000137__s00001760.tpn_0.json,85,106,191,22,0,1,5031370
a.s00000137__s00001760.tpn_1.json,26,28,54,6,0,1,1556949
a.s00000139__s00003398.tpn_0.json,26,28,54,6,0,1,1300619
a.s00000141__s00003407.tpn_0.json,106,127,233,28,0,1,6804337
a.s00000141__s00003430.tpn_0.json,115,138,253,31,0,1,9658457
a.s00000141__s00003433.tpn_0.json,69,81,150,18,0,1,4648927
a.s00000143__s00003440.tpn_0.json,39,42,81,9,0,1,1418685
a.s00000145__s00003476.tpn_0.json,90,104,194,24,0,1,5109123
a.s00000145__s00003497.tpn_0.json,51,56,107,13,0,1,1949491
a.s00000147__s00003504.tpn_0.json,68,81,149,18,0,1,3711785
a.s00000147__s00003532.tpn_0.json,39,42,81,9,0,1,1362608
a.s00000147__s00003539.tpn_0.json,37,40,77,9,0,1,1524518
a.s00000147__s00003555.tpn_0.json,37,40,77,9,0,1,2181191
a.s00000147__s00003560.tpn_0.json,37,40,77,9,0,1,1328452
a.s00000149__s00003561.tpn_0.json,73,85,158,19,0,1,3617693
a.s00000149__s00003574.tpn_0.json,71,85,156,19,0,1,4045622
a.s00000153__s00001278.tpn_0.json,113,128,241,31,0,1,6974129
a.s00000157__s00003209.tpn_0.json,53,61,114,14,0,1,2350244
a.s00000159__s00003186.tpn_0.json,53,60,113,13,0,1,3241736
a.s00000159__s00003195.tpn_0.json,94,124,218,24,0,1,7280461
a.s00000161__s00002770.tpn_0.json,108,130,238,28,0,1,6224103
a.s00000161__s00003594.tpn_0.json,84,103,187,22,0,1,4212541
a.s00000161__s00003645.tpn_0.json,62,71,133,16,0,1,3810392
a.s00000161__s00003650.tpn_0.json,84,102,186,22,0,1,4079531
a.s00000161__s00003654.tpn_0.json,72,81,153,18,0,1,3923614
a.s00000161__s00003660.tpn_0.json,39,42,81,9,0,1,4826847
a.s00000161__s00003660.tpn_1.json,28,30,58,6,0,1,1718203
a.s00000161__s00003668.tpn_0.json,44,50,94,11,0,1,2253689
a.s00000163__s00002319.tpn_0.json,33,38,71,8,0,1,2125277
a.s00000163__s00002319.tpn_1.json,28,30,58,6,0,1,1531989
a.s00000163__s00002817.tpn_0.json,28,30,58,6,0,1,1343806
a.s00000163__s00002817.tpn_1.json,33,38,71,8,0,1,1829865
a.s00000163__s00002857.tpn_0.json,33,38,71,8,0,1,2156477
a.s00000163__s00002857.tpn_1.json,28,30,58,6,0,1,1830029
a.s00000163__s00002890.tpn_0.json,28,30,58,6,0,1,1458588
a.s00000163__s00002890.tpn_1.json,33,38,71,8,0,1,2320194
a.s00000163__s00003092.tpn_0.json,68,78,146,18,0,1,3631568
a.s00000165__s00003643.tpn_0.json,37,40,77,9,0,1,4576100
a.s00000167__s00003586.tpn_0.json,44,50,94,11,0,1,5343367
a.s00000171__s00001480.tpn_0.json,26,28,54,6,0,1,1158988
a.s00000173__s00001672.tpn_0.json,127,168,295,34,0,1,8580834
a.s00000175__s00003677.tpn_0.json,33,38,71,8,0,1,1470657
a.s00000177__s00002195.tpn_0.json,71,84,155,18,0,1,3190420
a.s00000177__s00002195.tpn_1.json,44,48,92,11,0,1,1757202
a.s00000177__s00002300.tpn_0.json,88,105,193,23,0,1,5728602
a.s00000177__s00002531.tpn_0.json,133,150,283,36,0,1,9094234
a.s00000177__s00002843.tpn_0.json,82,92,174,21,0,1,5355355
a.s00000177__s00002855.tpn_0.json,79,95,174,21,0,1,6189701
a.s00000177__s00002888.tpn_0.json,79,95,174,21,0,1,5692476
a.s00000177__s00003710.tpn_0.json,35,40,75,9,0,1,1259238
a.s00000177__s00003710.tpn_1.json,33,36,69,8,0,1,1945550
a.s00000177__s00003710.tpn_2.json,25,27,52,6,0,1,868174
a.s00000183__s00002123.tpn_0.json,26,29,55,6,0,1,1448735
a.s00000183__s00002123.tpn_1.json,26,28,54,6,0,1,1560808
a.s00000183__s00002137.tpn_0.json,26,28,54,6,0,1,1013827
a.s00000183__s00002519.tpn_0.json,26,29,55,6,0,1,1526571
a.s00000183__s00002519.tpn_1.json,26,28,54,6,0,1,1812869
a.s00000183__s00003704.tpn_0.json,26,29,55,6,0,1,898306
a.s00000183__s00003704.tpn_1.json,26,28,54,6,0,1,1069002
a.s00000195__s00002154.tpn_0.json,57,64,121,14,0,1,3328931
a.s00000195__s00002180.tpn_0.json,57,64,121,14,0,1,3092059
a.s00000197__s00002170.tpn_0.json,66,77,143,17,0,1,4628236
a.s00000197__s00003725.tpn_0.json,63,72,135,16,0,1,3705627
a.s00000197__s00003735.tpn_0.json,66,77,143,17,0,1,3513748
a.s00000199__s00003744.tpn_0.json,26,28,54,6,0,1,1578214
a.s00000199__s00003752.tpn_0.json,41,46,87,10,0,1,2563962
a.s00000199__s00003755.tpn_0.json,141,167,308,38,0,1,9904935
a.s00000199__s00003773.tpn_0.json,87,100,187,23,0,1,5362333
a.s00000199__s00003802.tpn_0.json,32,35,67,8,0,1,1876172
a.s00000201__s00003776.tpn_0.json,70,78,148,18,0,1,4568957
a.s00000201__s00003794.tpn_0.json,59,66,125,15,0,1,3452334
a.s00000205__s00003812.tpn_0.json,41,46,87,10,0,1,1523861
b3.s00000023__s00001331.tpn_0.json,79,92,171,21,0,1,5110683
b3.s00000025__s00001294.tpn_0.json,87,100,187,24,0,1,6066298
b3.s00000039__s00001153.tpn_0.json,63,73,136,16,0,1,3206020
b3.s00000043__s00001051.tpn_0.json,50,57,107,14,0,1,2276596
b3.s00000049__s00002166.tpn_0.json,73,80,153,19,0,1,5052717
b3.s00000055__s00007041.tpn_0.json,57,69,126,14,0,1,3227203
b3.s00000063__s00001398.tpn_0.json,120,161,281,32,0,1,10578192
b3.s00000065__s00001355.tpn_0.json,68,79,147,17,0,1,4171406
b3.s00000067__s00001373.tpn_0.json,24,27,51,5,0,1,1467537
b3.s00000071__s00001480.tpn_0.json,73,96,169,20,0,1,3988149
b3.s00000075__s00001509.tpn_0.json,38,46,84,10,0,1,2451397
b3.s00000081__s00001552.tpn_0.json,44,50,94,11,0,1,2825055
b3.s00000083__s00001558.tpn_0.json,32,35,67,8,0,1,1987506
b3.s00000083__s00001558.tpn_1.json,30,33,63,7,0,1,1294132
b3.s00000085__s00001578.tpn_0.json,44,51,95,11,0,1,2368553
b3.s00000089__s00001591.tpn_0.json,61,76,137,16,0,1,3557346
b3.s00000095__s00004419.tpn_0.json,26,28,54,6,0,1,1265806
b3.s00000095__s00004419.tpn_1.json,38,41,79,9,0,1,1988245
b3.s00000095__s00004419.tpn_2.json,33,38,71,8,0,1,1988245
b3.s00000101__s00004470.tpn_0.json,179,268,447,46,0,1,16201783
b3.s00000109__s00004491.tpn_0.json,79,89,168,21,0,1,3701029
b3.s00000113__s00004502.tpn_0.json,53,64,117,14,0,1,5887639
b3.s00000115__s00004508.tpn_0.json,215,296,511,58,0,1,19622507
b3.s00000119__s00001595.tpn_0.json,73,85,158,18,0,1,3613998
b3.s00000121__s00001656.tpn_0.json,71,83,154,18,0,1,2889096
b3.s00000123__s00001638.tpn_0.json,90,111,201,23,0,1,6390694
b3.s00000125__s00001623.tpn_0.json,56,68,124,13,0,1,3552584
b3.s00000127__s00001685.tpn_0.json,98,128,226,25,0,1,6885620
b3.s00000129__s00001695.tpn_0.json,142,182,324,39,0,1,10580820
b3.s00000131__s00001754.tpn_0.json,94,119,213,24,0,1,5086544
b3.s00000135__s00001774.tpn_0.json,79,88,167,20,0,1,4638992
b3.s00000139__s00001839.tpn_0.json,120,153,273,33,0,1,8581326
b3.s00000141__s00001898.tpn_0.json,137,172,309,37,0,1,9975216
b3.s00000143__s00001891.tpn_0.json,37,48,85,9,0,1,1649563
b3.s00000147__s00001992.tpn_0.json,48,64,112,12,0,1,2156313
b3.s00000149__s00001958.tpn_0.json,127,162,289,33,0,1,7077663
b3.s00000151__s00001932.tpn_0.json,133,160,293,35,0,1,9624794
b3.s00000157__s00001981.tpn_0.json,24,27,51,5,0,1,1306941
b3.s00000159__s00002001.tpn_0.json,48,64,112,12,0,1,2499674
b3.s00000161__s00001996.tpn_0.json,73,93,166,18,0,1,5192541
b3.s00000161__s00001996.tpn_1.json,31,34,65,7,0,1,1225575
b3.s00000163__s00001994.tpn_0.json,130,162,292,34,0,1,8706125
b3.s00000165__s00002002.tpn_0.json,106,133,239,30,0,1,6363763
b3.s00000167__s00002019.tpn_0.json,100,132,232,26,0,1,5828195
b3.s00000169__s00002052.tpn_0.json,200,249,449,56,0,1,16496785
b3.s00000175__s00002042.tpn_0.json,51,61,112,13,0,1,2610269
b3.s00000177__s00002131.tpn_0.json,132,158,290,35,0,1,8840120
b3.s00000185__s00002121.tpn_0.json,29,34,63,7,0,1,1777893
b3.s00000187__s00002187.tpn_0.json,63,76,139,16,0,1,8774190
b3.s00000189__s00002202.tpn_0.json,33,36,69,8,0,1,1251438
b3.s00000191__s00002237.tpn_0.json,73,82,155,19,0,1,4892695
b3.s00000191__s00002237.tpn_1.json,150,179,329,41,0,1,10150428
b3.s00000193__s00002313.tpn_0.json,160,201,361,46,0,1,11867317
b3.s00000199__s00002398.tpn_0.json,108,137,245,31,0,1,6829379
b3.s00000207__s00001809.tpn_0.json,125,149,274,33,0,1,8336901
b3.s00000209__s00001792.tpn_0.json,90,102,192,24,0,1,5060599
b3.s00000211__s00001787.tpn_0.json,48,52,100,12,0,1,2225116
b3.s00000213__s00002690.tpn_0.json,50,57,107,13,0,1,2533173
b3.s00000215__s00002639.tpn_0.json,65,82,147,17,0,1,4287502
b3.s00000217__s00002570.tpn_0.json,93,108,201,25,0,1,6412205
b3.s00000219__s00002563.tpn_0.json,34,37,71,7,0,1,1732489
b3.s00000221__s00002545.tpn_0.json,93,105,198,26,0,1,6003406
b3.s00000223__s00002622.tpn_0.json,48,55,103,12,0,1,3132537
b3.s00000229__s00002611.tpn_0.json,32,35,67,8,0,1,2105818
b3.s00000235__s00002621.tpn_0.json,32,35,67,8,0,1,1370325
b3.s00000237__s00002663.tpn_0.json,33,36,69,8,0,1,1354890
b3.s00000237__s00002663.tpn_1.json,30,33,63,7,0,1,1626984
b3.s00000237__s00002663.tpn_2.json,63,72,135,17,0,1,3525653
b3.s00000241__s00002652.tpn_0.json,32,35,67,8,0,1,1944401
b3.s00000243__s00004463.tpn_0.json,81,94,175,21,0,1,5419971
b3.s00000245__s00005905.tpn_0.json,77,101,178,20,0,1,4281837
b3.s00000247__s00005917.tpn_0.json,100,126,226,25,0,1,7631212
b3.s00000249__s00005920.tpn_0.json,44,51,95,12,0,1,2514043
b3.s00000251__s00005947.tpn_0.json,105,148,253,29,0,1,7888364
b3.s00000253__s00005974.tpn_0.json,123,149,272,32,0,1,7963736
b3.s00000259__s00002348.tpn_0.json,110,130,240,30,0,1,7721034
b3.s00000265__s00003747.tpn_0.json,71,84,155,19,0,1,4765351
b3.s00000267__s00003764.tpn_0.json,77,100,177,22,0,1,5387621
b3.s00000267__s00003764.tpn_1.json,46,51,97,12,0,1,2804036
b3.s00000271__s00002710.tpn_0.json,208,256,464,57,0,1,16565917
b3.s00000275__s00002417.tpn_0.json,26,28,54,6,0,1,1294871
b3.s00000277__s00002499.tpn_0.json,268,313,581,72,0,1,21809692
b3.s00000285__s00002754.tpn_0.json,217,269,486,60,0,1,15221947
b3.s00000289__s00002759.tpn_0.json,286,361,647,79,0,1,31493027
b3.s00000293__s00002789.tpn_0.json,101,115,216,27,0,1,5331544
b3.s00000297__s00002867.tpn_0.json,52,66,118,14,0,1,2380048
b3.s00000299__s00002802.tpn_0.json,31,36,67,8,0,1,1087393
b3.s00000303__s00002838.tpn_0.json,97,120,217,26,0,1,5404207
b3.s00000309__s00002823.tpn_0.json,37,48,85,9,0,1,1374677
b3.s00000309__s00002823.tpn_1.json,41,45,86,10,0,1,4946966
b3.s00000311__s00002845.tpn_0.json,51,56,107,13,0,1,1907536
b3.s00000313__s00003131.tpn_0.json,170,199,369,45,0,1,12894035
b3.s00000315__s00003116.tpn_0.json,37,40,77,9,0,1,5210029
b3.s00000329__s00002947.tpn_0.json,178,227,405,48,0,1,11100460
b3.s00000329__s00002947.tpn_1.json,41,45,86,10,0,1,2569956
b3.s00000331__s00002882.tpn_0.json,236,296,532,66,0,1,23436266
b3.s00000335__s00002925.tpn_0.json,26,28,54,6,0,1,944203
b3.s00000335__s00002925.tpn_1.json,29,34,63,7,0,1,972282
b3.s00000341__s00003004.tpn_0.json,135,170,305,36,0,1,7187929
b3.s00000341__s00003004.tpn_1.json,41,45,86,10,0,1,2137265
b3.s00000343__s00003019.tpn_0.json,37,40,77,9,0,1,1585768
b3.s00000343__s00003019.tpn_1.json,252,323,575,66,0,1,26202534
b3.s00000345__s00003029.tpn_0.json,75,90,165,20,0,1,3450528
b3.s00000347__s00003039.tpn_0.json,53,64,117,14,0,1,2558215
b3.s00000349__s00003046.tpn_0.json,53,64,117,14,0,1,3482138
b3.s00000351__s00003073.tpn_0.json,116,130,246,32,0,1,7190803
b3.s00000355__s00003200.tpn_0.json,195,234,429,52,0,1,16198992
b3.s00000357__s00003150.tpn_0.json,35,38,73,9,0,1,2142930
b3.s00000357__s00003150.tpn_1.json,37,40,77,9,0,1,2132585
b3.s00000359__s00003133.tpn_0.json,26,28,54,6,0,1,871868
b3.s00000363__s00003167.tpn_0.json,26,28,54,6,0,1,1261126
b3.s00000367__s00003188.tpn_0.json,46,52,98,12,0,1,1624521
b3.s00000373__s00003408.tpn_0.json,245,355,600,64,0,1,18411793
b3.s00000373__s00003408.tpn_1.json,41,45,86,10,0,1,1512695
b3.s00000375__s00003221.tpn_0.json,37,48,85,9,0,1,1420820
b3.s00000375__s00003221.tpn_1.json,48,52,100,12,0,1,2182997
b3.s00000377__s00003371.tpn_0.json,26,28,54,6,0,1,915302
b3.s00000383__s00003316.tpn_0.json,54,60,114,14,0,1,3906701
b3.s00000387__s00003400.tpn_0.json,74,87,161,19,0,1,3217104
b3.s00000389__s00003421.tpn_0.json,41,45,86,10,0,1,2559693
b3.s00000389__s00003421.tpn_1.json,213,286,499,57,0,1,18017198
b3.s00000393__s00003428.tpn_0.json,238,302,540,63,0,1,18110387
b3.s00000397__s00003493.tpn_0.json,69,85,154,18,0,1,3311196
b3.s00000397__s00003493.tpn_1.json,37,40,77,9,0,1,2467653
b3.s00000399__s00003457.tpn_0.json,61,69,130,17,0,1,2948868
b3.s00000401__s00003486.tpn_0.json,29,34,63,7,0,1,1027785
b3.s00000405__s00005767.tpn_0.json,68,75,143,18,0,1,4859935
b3.s00000405__s00005767.tpn_1.json,25,27,52,6,0,1,1514173
b3.s00000407__s00005809.tpn_0.json,28,31,59,7,0,1,1767219
b3.s00000415__s00005865.tpn_0.json,26,29,55,6,0,1,1551941
b3.s00000423__s00003205.tpn_0.json,47,56,103,13,0,1,3004371
b3.s00000427__s00004153.tpn_0.json,26,29,55,6,0,1,1501775
b3.s00000433__s00004148.tpn_0.json,24,27,51,5,0,1,1582566
b3.s00000435__s00006791.tpn_0.json,42,48,90,10,0,1,2700748
b3.s00000435__s00006791.tpn_1.json,26,28,54,6,0,1,1648085
b3.s00000437__s00006806.tpn_0.json,25,27,52,6,0,1,1538722
b3.s00000439__s00006822.tpn_0.json,40,44,84,10,0,1,2249748
b3.s00000455__s00003511.tpn_0.json,168,203,371,48,0,1,17556345
b3.s00000457__s00003506.tpn_0.json,59,74,133,16,0,1,4587348
b3.s00000459__s00003550.tpn_0.json,97,123,220,25,0,1,8045430
b3.s00000463__s00003563.tpn_0.json,40,44,84,10,0,1,2719304
b3.s00000463__s00003563.tpn_1.json,46,61,107,12,0,1,3668515
b3.s00000465__s00003583.tpn_0.json,68,84,152,20,0,1,5745516
b3.s00000465__s00003583.tpn_1.json,40,44,84,10,0,1,2761752
b3.s00000469__s00003601.tpn_0.json,116,184,300,33,0,1,12347465
b3.s00000471__s00003634.tpn_0.json,113,125,238,30,0,1,16352938
b3.s00000477__s00003667.tpn_0.json,40,44,84,10,0,1,2570038
b3.s00000479__s00003696.tpn_0.json,49,56,105,12,0,1,3524668
b3.s00000483__s00003713.tpn_0.json,37,40,77,9,0,1,2546884
b3.s00000489__s00004071.tpn_0.json,83,100,183,22,0,1,7033901
b3.s00000493__s00004275.tpn_0.json,47,56,103,12,0,1,3293708
b3.s00000493__s00004275.tpn_1.json,49,56,105,12,0,1,3512270
b3.s00000495__s00004167.tpn_0.json,34,42,76,8,0,1,2100646
b3.s00000499__s00004247.tpn_0.json,99,120,219,26,0,1,8772794
b3.s00000501__s00004188.tpn_0.json,44,48,92,11,0,1,2830720
b3.s00000505__s00004223.tpn_0.json,92,106,198,24,0,1,7311004
b3.s00000511__s00004317.tpn_0.json,121,178,299,31,0,1,14173143
b3.s00000515__s00004381.tpn_0.json,69,91,160,19,0,1,4582668
b3.s00000517__s00004368.tpn_0.json,34,42,76,8,0,1,2154260
b3.s00000521__s00004892.tpn_0.json,97,161,258,25,0,1,10199526
b3.s00000527__s00004933.tpn_0.json,77,114,191,20,0,1,6110306
b3.s00000529__s00004946.tpn_0.json,26,28,54,6,0,1,1531415
b3.s00000529__s00004946.tpn_1.json,106,156,262,27,0,1,11450226
b3.s00000531__s00004958.tpn_0.json,73,88,161,20,0,1,5700358
b3.s00000533__s00004974.tpn_0.json,26,29,55,6,0,1,1620827
b3.s00000533__s00004974.tpn_1.json,26,28,54,6,0,1,1544551
b3.s00000535__s00005013.tpn_0.json,187,220,407,52,0,1,18782002
b3.s00000535__s00005013.tpn_1.json,40,44,84,10,0,1,2303198
b3.s00000539__s00005008.tpn_0.json,43,48,91,11,0,1,2783838
b3.s00000543__s00005062.tpn_0.json,153,200,353,40,0,1,13186902
b3.s00000547__s00003797.tpn_0.json,100,122,222,27,0,1,9198671
b3.s00000551__s00004288.tpn_0.json,42,49,91,10,0,1,2941069
b3.s00000555__s00006385.tpn_0.json,34,42,76,8,0,1,2268550
b3.s00000559__s00006401.tpn_0.json,62,74,136,16,0,1,4232492
b3.s00000561__s00006418.tpn_0.json,79,96,175,20,0,1,5954882
b3.s00000565__s00003960.tpn_0.json,26,28,54,6,0,1,1578214
b3.s00000565__s00003960.tpn_1.json,28,30,58,6,0,1,1823625
b3.s00000565__s00003960.tpn_2.json,308,407,715,84,0,1,42213261
b3.s00000567__s00003859.tpn_0.json,40,44,84,10,0,1,1453005
b3.s00000575__s00003884.tpn_0.json,100,113,213,28,0,1,7048598
b3.s00000579__s00003904.tpn_0.json,24,27,51,5,0,1,1482480
b3.s00000579__s00003904.tpn_1.json,121,139,260,33,0,1,9946151
b3.s00000585__s00004536.tpn_0.json,35,40,75,9,0,1,2281030
b3.s00000589__s00000590.tpn_0.json,72,101,173,19,0,1,7269541
b3.s00000591__s00004601.tpn_0.json,280,359,639,78,0,1,37866314
b3.s00000601__s00004698.tpn_0.json,25,27,52,6,0,1,1643487
b3.s00000601__s00004698.tpn_1.json,34,37,71,8,0,1,2254510
b3.s00000601__s00004698.tpn_2.json,157,194,351,44,0,1,14058853
b3.s00000609__s00004761.tpn_0.json,100,115,215,27,0,1,6903355
b3.s00000609__s00004761.tpn_1.json,26,28,54,6,0,1,1595046
b3.s00000611__s00004786.tpn_0.json,147,179,326,41,0,1,11770023
b3.s00000613__s00004794.tpn_0.json,105,139,244,29,0,1,7448365
b3.s00000613__s00004794.tpn_1.json,41,45,86,10,0,1,2632684
b3.s00000615__s00004851.tpn_0.json,25,27,52,6,0,1,904382
b3.s00000621__s00004875.tpn_0.json,72,83,155,19,0,1,5496328
b3.s00000621__s00004875.tpn_1.json,26,28,54,6,0,1,1620005
b3.s00000625__s00004121.tpn_0.json,107,132,239,29,0,1,7908643
b3.s00000629__s00007077.tpn_0.json,61,72,133,16,0,1,5893550
b3.s00000631__s00007081.tpn_0.json,81,92,173,22,0,1,6185678
b3.s00000633__s00007100.tpn_0.json,68,77,145,17,0,1,5145906
b3.s00000639__s00004334.tpn_0.json,33,38,71,8,0,1,2056720
b3.s00000641__s00005690.tpn_0.json,56,67,123,16,0,1,4154164
b3.s00000643__s00005750.tpn_0.json,26,28,54,6,0,1,1669350
b3.s00000649__s00007246.tpn_0.json,32,35,67,8,0,1,2091040
b3.s00000649__s00007246.tpn_1.json,169,235,404,49,0,1,19846735
b3.s00000651__s00007204.tpn_0.json,50,55,105,13,0,1,3193376
b3.s00000653__s00007159.tpn_0.json,55,60,115,14,0,1,3658417
b3.s00000657__s00007182.tpn_0.json,65,72,137,17,0,1,4542026
b3.s00000661__s00007121.tpn_0.json,62,75,137,18,0,1,5103047
b3.s00000675__s00007227.tpn_0.json,28,31,59,7,0,1,1281078
b3.s00000675__s00007227.tpn_1.json,30,33,63,7,0,1,1811638
b3.s00000679__s00007333.tpn_0.json,112,129,241,30,0,1,10377201
b3.s00000685__s00007369.tpn_0.json,83,92,175,22,0,1,6533309
b3.s00000689__s00007392.tpn_0.json,79,88,167,21,0,1,6433388
b3.s00000693__s00007414.tpn_0.json,46,53,99,12,0,1,3696103
b3.s00000697__s00007417.tpn_0.json,54,67,121,14,0,1,3783216
b3.s00000699__s00007438.tpn_0.json,90,99,189,24,0,1,7261906
b3.s00000705__s00005113.tpn_0.json,110,141,251,29,0,1,9687686
b3.s00000715__s00005161.tpn_0.json,84,101,185,21,0,1,6584707
b3.s00000717__s00005121.tpn_0.json,53,62,115,14,0,1,3774595
b3.s00000719__s00005139.tpn_0.json,29,34,63,7,0,1,1835448
b3.s00000723__s00005165.tpn_0.json,105,120,225,27,0,1,9298182
b3.s00000725__s00005325.tpn_0.json,192,269,461,52,0,1,23179197
b3.s00000727__s00005175.tpn_0.json,95,107,202,25,0,1,13116292
b3.s00000729__s00005191.tpn_0.json,85,98,183,22,0,1,7109930
b3.s00000731__s00005668.tpn_0.json,152,188,340,41,0,1,16906405
b3.s00000739__s00005638.tpn_0.json,168,198,366,46,0,1,15750618
b3.s00000741__s00005271.tpn_0.json,96,107,203,26,0,1,7211493
b3.s00000743__s00005239.tpn_0.json,71,87,158,20,0,1,4824959
b3.s00000743__s00005239.tpn_1.json,44,48,92,11,0,1,1654654
b3.s00000745__s00005217.tpn_0.json,45,50,95,11,0,1,3020218
b3.s00000747__s00005617.tpn_0.json,123,144,267,33,0,1,10528930
b3.s00000749__s00005225.tpn_0.json,41,46,87,10,0,1,2806581
b3.s00000753__s00005540.tpn_0.json,26,28,54,6,0,1,1923054
b3.s00000755__s00005630.tpn_0.json,67,78,145,17,0,1,5340083
b3.s00000757__s00005536.tpn_0.json,41,46,87,11,0,1,2879901
b3.s00000759__s00005441.tpn_0.json,262,354,616,70,0,1,33026659
b3.s00000763__s00005368.tpn_0.json,61,68,129,16,0,1,3937901
b3.s00000765__s00005402.tpn_0.json,121,140,261,31,0,1,16506556
b3.s00000767__s00005389.tpn_0.json,90,103,193,24,0,1,6713611
b3.s00000769__s00005414.tpn_0.json,105,122,227,28,0,1,8872469
b3.s00000771__s00005478.tpn_0.json,28,31,59,7,0,1,1686182
b3.s00000771__s00005478.tpn_1.json,36,39,75,9,0,1,2503780
b3.s00000775__s00005494.tpn_0.json,249,353,602,69,0,1,36146880
b3.s00000779__s00000780.tpn_0.json,51,56,107,13,0,1,3020792
b3.s00000785__s00005576.tpn_0.json,108,141,249,29,0,1,6437083
b3.s00000787__s00005604.tpn_0.json,33,36,69,8,0,1,2094488
b3.s00000789__s00005676.tpn_0.json,26,28,54,6,0,1,1249550
b3.s00000791__s00005678.tpn_0.json,172,256,428,48,0,1,23824785
b3.s00000797__s00005997.tpn_0.json,33,38,71,8,0,1,2045964
b3.s00000799__s00006016.tpn_0.json,83,103,186,21,0,1,6555970
b3.s00000803__s00006033.tpn_0.json,112,132,244,31,0,1,9819464
b3.s00000805__s00006051.tpn_0.json,44,59,103,11,0,1,3091813
b3.s00000807__s00006144.tpn_0.json,88,119,207,23,0,1,7504442
b3.s00000809__s00006086.tpn_0.json,35,38,73,8,0,1,2323478
b3.s00000809__s00006086.tpn_1.json,28,31,59,7,0,1,1649563
b3.s00000809__s00006086.tpn_2.json,28,30,58,6,0,1,1709828
b3.s00000811__s00006124.tpn_0.json,26,29,55,6,0,1,1517703
b3.s00000813__s00006164.tpn_0.json,56,80,136,15,0,1,4283232
b3.s00000815__s00006174.tpn_0.json,44,59,103,11,0,1,2098840
b3.s00000817__s00006282.tpn_0.json,26,29,55,6,0,1,1207266
b3.s00000819__s00006178.tpn_0.json,24,27,51,5,0,1,788861
b3.s00000821__s00006189.tpn_0.json,24,27,51,5,0,1,1412527
b3.s00000823__s00006200.tpn_0.json,139,160,299,36,0,1,12442377
b3.s00000825__s00006242.tpn_0.json,24,27,51,5,0,1,1386089
b3.s00000827__s00006253.tpn_0.json,24,27,51,5,0,1,1355711
b3.s00000829__s00006264.tpn_0.json,24,27,51,5,0,1,1579200
b3.s00000831__s00006275.tpn_0.json,26,29,55,6,0,1,1125818
b3.s00000833__s00006285.tpn_0.json,85,100,185,23,0,1,6969038
b3.s00000835__s00006328.tpn_0.json,72,83,155,19,0,1,5450432
b3.s00000839__s00006358.tpn_0.json,38,46,84,10,0,1,2503697
b3.s00000845__s00006491.tpn_0.json,60,68,128,17,0,1,4479955
b3.s00000849__s00006439.tpn_0.json,37,40,77,9,0,1,1719352
b3.s00000861__s00006505.tpn_0.json,47,52,99,12,0,1,4419362
b3.s00000865__s00006515.tpn_0.json,30,32,62,6,0,1,2528329
b3.s00000865__s00006515.tpn_1.json,83,95,178,21,0,1,6080913
b3.s00000867__s00006514.tpn_0.json,52,57,109,13,0,1,3541500
b3.s00000871__s00006546.tpn_0.json,41,45,86,10,0,1,2605754
b3.s00000873__s00006556.tpn_0.json,59,67,126,15,0,1,3971810
b3.s00000875__s00006563.tpn_0.json,62,70,132,16,0,1,3998904
b3.s00000877__s00006580.tpn_0.json,109,134,243,29,0,1,8954492
b3.s00000883__s00006615.tpn_0.json,28,31,59,7,0,1,4379377
b3.s00000889__s00006646.tpn_0.json,26,28,54,6,0,1,1586343
b3.s00000889__s00006646.tpn_1.json,32,35,67,8,0,1,6396030
b3.s00000893__s00006668.tpn_0.json,63,77,140,16,0,1,5457739
b3.s00000895__s00006681.tpn_0.json,97,115,212,26,0,1,7924161
b3.s00000897__s00006690.tpn_0.json,73,80,153,19,0,1,5386883
b3.s00000901__s00006709.tpn_0.json,51,61,112,13,0,1,3380328
b3.s00000903__s00006712.tpn_0.json,45,54,99,11,0,1,2960527
b3.s00000905__s00006739.tpn_0.json,80,97,177,21,0,1,6713365
b3.s00000907__s00006745.tpn_0.json,47,52,99,12,0,1,3340507
b3.s00000909__s00006762.tpn_0.json,68,86,154,19,0,1,5115199
c.s00000030__s00000596.tpn_0.json,268,345,613,73,0,1,37289037
c.s00000030__s00000703.tpn_0.json,277,327,604,76,0,1,29185148
c.s00000030__s00000812__s00000821.tpn_0.json,26,28,54,6,0,1,1415565
c.s00000030__s00000838.tpn_0.json,74,87,161,19,0,1,6440613
c.s00000030__s00000861.tpn_0.json,28,31,59,7,0,1,1065061
c.s00000030__s00000869.tpn_0.json,126,155,281,33,0,1,8136484
c.s00000030__s00000886.tpn_0.json,126,155,281,33,0,1,12089082
c.s00000030__s00000887.tpn_0.json,126,155,281,33,0,1,11559014
c.s00000030__s00000888.tpn_0.json,74,87,161,19,0,1,5893468
c.s00000030__s00000889.tpn_0.json,64,77,141,15,0,1,4560992
c.s00000030__s00000890.tpn_0.json,64,77,141,15,0,1,4783824
c.s00000032__s00000348.tpn_0.json,315,397,712,90,0,1,47022784
c.s00000038__s00001082.tpn_0.json,39,42,81,9,0,1,2285710
c.s00000038__s00001082.tpn_1.json,59,64,123,15,0,1,3201094
c.s00000040__s00000980.tpn_0.json,57,62,119,14,0,1,3304299
c.s00000040__s00001001.tpn_0.json,28,30,58,6,0,1,1445287
c.s00000040__s00001001.tpn_1.json,28,30,58,6,0,1,1341261
c.s00000040__s00001003.tpn_0.json,51,56,107,13,0,1,2842871
c.s00000040__s00001003.tpn_1.json,28,30,58,6,0,1,1640039
c.s00000040__s00001008.tpn_0.json,49,54,103,13,0,1,3460955
c.s00000040__s00001008.tpn_1.json,28,30,58,6,0,1,1760486
c.s00000040__s00001017.tpn_0.json,49,54,103,13,0,1,3312346
c.s00000040__s00001017.tpn_1.json,28,30,58,6,0,1,1779699
c.s00000821__s00000832.tpn_0.json,26,29,55,6,0,1,1521726
